35
45
00000000000000000000000000000000000
00011111110111111111111111112111010
00020000010100000000000202010111010
00011111010111011101111111010111010
00011111010000011101111111010111010
01011111010111211121111111010111010
01000000010111000001111111010111010
01111100010111011101111111010111210
00020100010111010100000000010000000
01110100012111010111111111011101110
01110100000000020002000002000101110
01110121111111211111110111210101110
00000001111111011111110111000201110
01211101111111011111110111211101110
01011101111111011111110111011100020
01011121111111011111110111011101110
01011101111111011111110200000201000
01011101111111011111110101111121000
02000200000002000200000101111100000
01110101111111011111110101111101110
01110101111111011111110102000001010
01110101111111011111110101111111010
01110101111111011111110100000200010
01110101111111011111110111110111010
00000101111111011111110000010111010
01111101111111211111112111010111010
01000002000200000002000111010000010
01000111011111211111110111010111110
01000111011111011111110111010000010
01000111011111011111110111011111010
01000111011111000002000202000001010
01000111211111210111110101111101010
01000111011111010000000201111101010
01000111011111011111111101111101010
01000000020000000001111101111101010
01110001110111111101111121111101010
01020002000111111101111101111101010
01011111110111111121111101111101110
01011111110000020001111100020000020
01011111110000011101111100011101110
01011111110000011100020000011101110
01211111112111011101110000011121110
00011111110111011101000000011100000
00011111110111211101111111211121110
00000000000000000000000000000000000