17
17
11111111111111111
2               3
2               3
2               3
2               3
2               3
2               3
2     2222      3
2     2222      3
2     2222      3
2               3
2               3
2               3
2               3
2               3
2               3
44444444444444444