16
16
0000000000000000
3222222222222223
3222222222222223
3222222222222223
3222222222222223
3222222222222223
3222222222222223
3222244422222223
3222255522222223
3222244422222223
3222222222222223
3222222222222223
3222222222222223
3222222222222223
3222222222222223
0000000000000000