16
16
3333222222223333
1              3
1      11111   3
1     3        3
3     3  1113333
3     3        3
3   13333      3
3   3   11133  3
3   3   3      3
3   3   1  33333
3       1      3
2       1      3
3       3      3
3 3333333      3
3              3
3332222222233333